d̪eɕɔi	d̪eɕɔ̃i	d̪eɕŏi	d̪eɕõi
bil̪it̪i	bilit̪i	bis̪it̪i	bisit̪i
makt̪aba	makt̪apa	makt̪aɦa	makt̪aha
dimitri	d̤imitri	t͡ɕimitri	t͡ɕʰimitri
belal	belal̪	belad	belad̪
d̪it̪amɔ	dit̪amɔ	t̪it̪amɔ	tit̪amɔ
ba̤ɡ̤ae̯	ba̤ɡ̤ãe̯	ba̤ɡ̤öe̯	ba̤ɡ̤õe̯
ae̯man̪	ae̯man	ae̯mað	ae̯maz
s̪urin̪	s̪ṳrin̪	s̪brin̪	s̪b̤rin̪
ol̪okɔ	olokɔ	od̪okɔ	odokɔ
d̪ibn̪a	d̪ĩbn̪a	d̪ɔbn̪a	d̪ɔ̃bn̪a
ɡod͡ʑar	ɡot͡ɕar	ɡozar	ɡosar
pɔraɡer	pɔraɡir	pɔraɡe̤r	pɔraɡi̤r
trina	drina	t͡ɕrina	d͡ʑrina
ɕripurɔ	t͡ɕripurɔ	sripurɔ	tripurɔ
karikɔrɔ	ɡarikɔrɔ	t͡ɕarikɔrɔ	d͡ʑarikɔrɔ
ad̪u	ad̪ṳ	ad̪ɔ	ad̪ɔ̤
rukʰe	ɽukʰe	r̤ukʰe	ɽ̤ukʰe
t̪aɽaɕer	taɽaɕer	n̪aɽaɕer	naɽaɕer
aieɸe	aeeɸe	akeɸe	aqeɸe
bil̪as̪i	bil̪aði	bil̪ahi	bil̪aɦi
sunshyne	sunshyn̪e	sunshyte	sunshyt̪e
mɔrmɔ	mɔr̤mɔ	mɔɔmɔ	mɔɔ̤mɔ
hel̪ɔs̪ɔ	hel̪ɔs̪œ	hel̪ɔs̪x	hel̪ɔs̪ç
ras̪t̪ʰa	res̪t̪ʰa	ra̤s̪t̪ʰa	re̤s̪t̪ʰa
peres̪	perøs̪	perəs̪	perɔs̪
bid̪̤an̪	pid̪̤an̪	did̪̤an̪	tid̪̤an̪
maitɔ	maitə	maitø	maitĕ
iun̪ibdi	i̤un̪ibdi	ɔun̪ibdi	ɔ̤un̪ibdi
ɸirmin̪o	ɸir̤min̪o	ɸiïmin̪o	ɸii̤min̪o
casual	casuĕl	casua̤l	casue̤l
toether	toethe̤r	toethær	toetha̤r
t̪el̪ɡu	t̪al̪ɡu	t̪e̤l̪ɡu	t̪a̤l̪ɡu
pl̪an̪	pl̪ĕn̪	pl̪a̤n̪	pl̪e̤n̪
d̤abi	d̤abi̤	d̤abɔ	d̤abɔ̤
root	roøt	rokt	roct
bɔrad̪	bɔred̪	bɔra̤d̪	bɔre̤d̪
ɕil̪pirɔ	ɕilpirɔ	ɕid̪̤pirɔ	ɕid̤pirɔ
ɡɔrb̤er	ɡɔrber	ɡɔrr̤er	ɡɔrrer
kard͡zer	kʰard͡zer	rard͡zer	r̤ard͡zer
mumbi	mṳmbi	mbmbi	mb̤mbi
t̪ɔrik	t̪ɔrikʰ	t̪ɔriü	t̪ɔriṳ
taut	tʰaut	jaut	j̤aut
metae̯	metĕe̯	meta̤e̯	mete̤e̯
oml̪in̪	o̤ml̪in̪	ɽml̪in̪	ɽ̤ml̪in̪
keybord	keübord	kecbord	kekbord
d̪it̪en̪	d̪iten̪	d̪iðen̪	d̪izen̪
al̪ie̯ar	al̪ie̯aɽ	al̪ie̯ar̤	al̪ie̯aɽ̤
s̪ahab	s̪a̤hab	s̪ɡhab	s̪ɡ̤hab
pl̪utoke	plutoke	pd̪utoke	pdutoke
tɔmas̪er	tɔmaðer	tɔmatʰer	tɔmad̤er
hed̪ae̯a	hed̪a̤e̯a	hed̪t̪e̯a	hed̪t̪ʰe̯a
tʰak	tʰakʰ	tʰar	tʰar̤
ɸɔreʂtɔ	ɸɔrøʂtɔ	ɸɔrəʂtɔ	ɸɔrɔʂtɔ
audi	aud̤i	aubi	aub̤i
kʰara	ɡ̤ara	t͡ɕʰara	d͡ʑ̤ara
olam	õlam	ɔlam	ɔ̃lam
miɕl̪e	meɕl̪e	mi̤ɕl̪e	me̤ɕl̪e
d͡ʑirnɔ	d͡ʑirn̪ɔ	d͡ʑirdɔ	d͡ʑird̪ɔ
haud͡ʑiŋ	haud͡ʑi̤ŋ	haud͡ʑd͡ʑŋ	haud͡ʑd͡ʑ̤ŋ
pɔribeɕe	pɔribet͡ɕe	pɔribeðe	pɔribed̪e
t̪ʰoe̯e	t̪ʰo̤e̯e	t̪ʰde̯e	t̪ʰd̤e̯e
bid͡ʑta	pid͡ʑta	ðid͡ʑta	s̪id͡ʑta
card	cĕrd	ca̤rd	ce̤rd
t͡ɕʰaori	t͡ɕʰaõri	t͡ɕʰaäri	t͡ɕʰaãri
riporter	riborter	rikʰorter	riɡ̤orter
s̪idrer	s̪idrer̤	s̪idreä	s̪idrea̤
ad̪owo	at̪owo	aɡowo	akowo
b̤ɔt̪e	b̤ɔt̪ʰe	b̤ɔee	b̤ɔe̤e
s̪aiɸun̪	s̪eiɸun̪	s̪a̤iɸun̪	s̪e̤iɸun̪
mat̪en̪	mat̪en	mat̪el̪	mat̪el
ɡɔritiŋ	ɡəritiŋ	ɡøritiŋ	ɡeritiŋ
ɕutiŋer	ɕut̪iŋer	ɕud̤iŋer	ɕud̪̤iŋer
mad̪ar	mĕd̪ar	ma̤d̪ar	me̤d̪ar
abid	apid	adid	atid
s̪e̯amit	s̪e̯amis	s̪e̯amik	s̪e̯amix
shesh	shes̪h	shedh	shed̪h
ɡul̪ie̯e	ɡulie̯e	ɡut̪ʰie̯e	ɡutʰie̯e
ɕikʰl̪am	ɕikʰl̪a̤m	ɕikʰl̪km	ɕikʰl̪kʰm
pɔrikʂar	pɔrikʂĕr	pɔrikʂa̤r	pɔrikʂe̤r
aɕbas̪ei	aɕpas̪ei	aɕd̪as̪ei	aɕt̪as̪ei
kae̯a	cae̯a	xae̯a	çae̯a
yuon	ŭuon	œuon	ɔuon
toŋɡa	toŋɡĕ	toŋɡa̤	toŋɡe̤
rɔkt̪im	rɔkʰt̪im	rɔwt̪im	rɔw̤t̪im
s̪aban̪a	s̪abana	s̪abaða	s̪abaza
krɔmɔke	krɔmɔqe	krɔmɔie	krɔmɔĕe
icloud	ecloud	kcloud	qcloud
t͡ɕʰaira	d͡ʑ̤aira	paira	baira
mart͡ɕiŋ	mar̤t͡ɕiŋ	mad̪t͡ɕiŋ	mad̪̤t͡ɕiŋ
od͡zaŋri	od͡zaŋri̤	od͡zaŋrd͡ʑ	od͡zaŋrd͡ʑ̤
d̤ukao	d̤uka̤o	d̤ukwo	d̤ukw̤o
is̪kɔn̪ɔ	iðkɔn̪ɔ	ifkɔn̪ɔ	ivkɔn̪ɔ
s̪kai	s̪ka̤i	s̪kt͡ɕi	s̪kt͡ɕʰi
exactspy	exactspu	exactspø	exactspŏ
ot̪iɡɔmɔ	õt̪iɡɔmɔ	it̪iɡɔmɔ	ĩt̪iɡɔmɔ
s̪ɔke	s̪ɔki	s̪ɔke̤	s̪ɔki̤
an̪ɔmɔ	an̪ŏmɔ	an̪ɔ̤mɔ	an̪o̤mɔ
bel̪l̪a	bell̪a	ben̪l̪a	benl̪a
teŋker	te̤ŋker	toŋker	to̤ŋker
